%%%%%%
% %. %
% %%.%
%P. .%
%%%%%%